Тілді таңдаңыз=Выберите язык
Бұл болашақта жазылады=Это будет написано в будущем
Ботты іске қосу=Запустить бота
Пайдаланушыны тіркеу=Зарегистрировать пользователя
Баланы қосу=Добавить ребенка
Балалар тізімін алу=Получить список детей
Қосымша ақпарат алу=Получить больше информации
Жазылымды жою=Удалить подписку
Артқа=Назад
Телефон нөміріңізді бөлісіңіз=Предоставьте доступ к номеру телефона
Сіз әлдеқашан тіркелгенсіз=Вы уже зарегестрированы
Балаңыздың staff_id жазыңыз=Пожалуйста, напишите staff_id вашего ребенка
Сіз тіркелмегенсіз, алдымен тіркеліңіз=Вы не зарегистрированы, сначала зарегистрируйтесь
Жазылым=Подписка
Жазылудан бас тарту=Отписаться
Жазылымнан бас тарту үшін бала идентификаторын жазыңыз=Напишите идентификатор ребенка, чтобы удалить подписку
Анықтама=Помощь
Жазылым сәтті жойылды=Подписка успешно удалена
Ондай бала жоқ, қайталап көріңіз=Нет такого ребенка, попробуйте еще раз
Бала идентификаторы=Идентификатор ребенка
staff_id=staff_id
table_id=table_id
Сізде жазылым жоқ=У вас нет подписки
Дерекқорда мұндай бала жоқ, қайталап көріңіз=В базе данных нет такого ребенка, попробуйте еще раз
Бала сәтті қосылды=Ребенок был успешно добавлен
Бұл баланыз дерекқорға қосылған=Такой ребенок уже добавлен в базу
Сан емес, қайталап көріңіз=Введено не число, попробуйте еще раз
Тіркеу сәтті өтті=Регистрация прошла успешно
Тіркелу=Регистрация
Сәлем,=Привет,
, танысқаныма қуаныштымын!, мәзір пәрменін таңдаңыз=, приятно познакомиться!, выберите команду меню
Кіру=Вход
Шығу=Выход
Контактіні бөлісу=Поделиться контактом
Тілді өзгерту=Изменить язык

